0
17
0 5 6 9 7 100 100 100 100 100 100 100 100 100 100 100 100
5 0 7 100 100 100 100 100 100 100 100 100 100 100 100 100 100
6 7 0 100 100 100 4 100 100 100 100 100 100 100 100 100 100
9 100 100 0 100 2 100 100 100 100 100 100 100 100 100 100 100
7 100 100 100 0 10 100 100 100 100 100 100 100 100 100 100 100
100 100 100 2 10 0 3 2 100 100 100 100 100 100 100 100 100 100
100 100 1 100 100 3 0 1 100 12 100 100 100 100 100 100 100
100 100 100 100 100 2 1 0 10 7 100 100 100 100 100 100 100
100 100 100 100 100 100 100 10 0 2 100 100 100 100 100 100 100
100 100 100 100 100 100 25 7 2 0 4 100 100 100 100 100 100
100 100 100 100 100 100 100 100 100 4 0 8 7 100 100 100 100
100 100 100 100 100 100 100 100 100 100 8 0 7 10 100 100 100
100 100 100 100 100 100 100 100 100 100 7 8 0 100 8 10 100
100 100 100 100 100 100 100 100 100 100 100 10 100 0 3 100 100
100 100 100 100 100 100 100 100 100 100 100 100 8 3 0 1 100
100 100 100 100 100 100 100 100 100 100 100 100 10 100 1 0 5 
100 100 100 100 100 100 100 100 100 100 100 100 100 100 100 5 0

