0
20
0 2 5 100 100 100 100 100 100 6 100 100 100 100 100 100 100 100 100 100
2 0 100 3 100 100 100 100 100 100 100 100 100 100 100 100 100 100 100 100
5 100 0 100 100 100 4 100 100 100 100 100 100 100 100 100 100 100 100 100
100 3 100 0 1 4 100 100 100 100 100 100 100 100 100 100 100 100 100 100
100 100 100 1 0 3 100 100 100 100 100 100 100 100 100 100 100 100 100 100
100 100 100 4 3 0 7 100 100 100 100 100 100 100 100 100 100 100 100 100
100 100 4 100 100 7 0 2 100 100 100 100 100 100 100 100 100 100 100 100
100 100 100 100 100 100 2 0 8 100 100 100 100 100 100 100 100 100 100 100
100 100 100 100 100 100 100 100 0 7 8 100 100 100 100 100 100 100 100 100
6 100 100 100 100 100 100 100 7 0 100 100 100 4 100 3 100 100 100 100
100 100 100 100 100 100 100 100 8 100 0 2 100 9 100 100 100 100 100 100
100 100 100 100 100 100 100 100 100 100 2 0 3 100 100 100 100 100 100 100
100 100 100 100 100 100 100 100 100 100 100 3 0 4 100 100 100 100 100 100
100 100 100 100 100 100 100 100 100 8 9 100 4 0 4 100 100 100 100 100
100 100 100 100 100 100 100 100 100 100 100 100 100 4 0 2 5 100 100 100
100 100 100 100 100 100 100 100 100 3 100 100 100 100 2 0 100 100 100 100
100 100 100 100 100 100 100 100 100 100 100 100 100 100 100 100 0 3 4 100
100 100 100 100 100 100 100 100 100 100 100 100 100 100 100 100 3 0 2 100
100 100 100 100 100 100 100 100 100 100 100 100 100 100 100 100 4 2 0 1
100 100 100 100 100 100 100 100 100 100 100 100 100 100 100 100 100 100 1 0
  